{
    "id": "medium_004",
    "name": "Pac-Maze",
    "difficulty": "medium",
    "width": 10,
    "height": 10,
    "solution": [
        [1, 1, 1, 1, 1, 1, 1, 1, 1, 1],
        [1, 0, 0, 0, 1, 1, 0, 0, 0, 1],
        [1, 0, 1, 0, 0, 0, 0, 1, 0, 1],
        [1, 0, 1, 1, 1, 1, 1, 1, 0, 1],
        [1, 0, 0, 0, 0, 0, 0, 0, 0, 1],
        [1, 1, 1, 0, 1, 1, 0, 1, 1, 1],
        [1, 0, 0, 0, 0, 0, 0, 0, 0, 1],
        [1, 0, 1, 1, 1, 1, 1, 1, 0, 1],
        [1, 0, 0, 0, 1, 1, 0, 0, 0, 1],
        [1, 1, 1, 1, 1, 1, 1, 1, 1, 1]
    ]
}
